Lektion 1

Bonjour! -> Guten Morgen
Bonjour monsieur -> Guten Tag, mein Herr!
Bonjour Madame Morel -> Guten Tag Frau Morel
Bonjour Madame Morel! -> Guten Tag Frau Morel!
Bonjour monsieur! -> Guten Tag der Herr
Bonjour, Monsieur Dubois! -> Guten Tag Herr Dubois!

Il est suisse -> Er ist Schweizer

Une fille suisse -> Ein Schweizer Mädchen

Madame Morel est une femme -> Frau Morel ist eine Frau
Madame Morel est suisse -> Frau Morel ist Schweizerin
Madame Dubois est suisse -> Frau Dubois ist Schweizerin

Je m'appelle Laurie Morel -> Ich heiße Laurie Morel
Je m'appelle Rémy Dubois -> Ich heiße Rémy Dubois

Merci Madame Dubois -> Danke Frau Dubois!

Monsieur Morel est suisse -> Herr Morel ist Schweizer

-------

Lektion 2

la nuit -> die Nacht

Bonne nuit -> Gute Nacht
Merci et bonne nuit -> Danke und gute Nacht!

Au revoir! -> Auf Wiedersehen
Au revoir, Monsieur Dubois! -> Auf Wiedersehen, Herr Dubois!

Oui au revoir -> Ja, auf Wiedersehen

Sophie est allemande -> Sophie ist Deutsche
Tu es allemand -> Du bist Deutscher
Tu es français -> Du bist Franzose

C'est un français/ Il est français -> Er ist Franzose

Je suis français -> Ich bin Französin

Elle est française -> Sie ist Französin

homme -> Mann

allemand -> deutsch

je -> ich

fille -> Mädchen

l' -> der

-------

Lektion 3

Au revoir et bonne nuit! -> Auf Wiedersehen und gute Nacht

Elle est allemande -> Sie ist Deutsche

Merci et bonne nuit! -> Danke und gute Nacht

Elle est française -> Elle ist Französin

Un garçon français -> Ein französischer Junge

Il est allemand -> Er ist Deutscher
Il est français -> Er ist Franzose

Bonjour, je m'appelle Duo! -> Guten Tag ich heiße Duo

La nuit est calme -> Die Nacht ist ruhig

Tu es allemand -> Du bist Deutscher
Un homme allemand -> Ein deutscher Mann

Monsieur Dubios est un homme -> Herr Dubios ist ein Mann